F 0,255,0
C 255,255,0

NO ./textures/bluestone.xpm
SO ./textures/bluestone.xpm
WE ./textures/bluestone.xpm
EA ./textures/bluestone.xpm

1111111111111111111
1000011001001001001
1S00000010010010001
1000001001001001001
1000001001001001001
1000000011100000001
1000011111111000001
1111001001100001111
1000000101010000001
1111111111111111111
